# DATATYPES

cowpi_ioport_t	KEYWORD1
cowpi_spi_t	KEYWORD1
cowpi_i2c_t	KEYWORD1
cowpi_pininterrupt_t	KEYWORD1
cowpi_timer8bit_t	KEYWORD1
cowpi_timer16bit_t	KEYWORD1


# FUNCTIONS

cowpi_setup	KEYWORD2
cowpi_get_keypress	KEYWORD2
cowpi_get_keypresses	KEYWORD2
cowpi_left_button_is_pressed	KEYWORD2
cowpi_right_button_is_pressed	KEYWORD2
cowpi_left_switch_is_in_left_position	KEYWORD2
cowpi_right_switch_is_in_left_position	KEYWORD2
cowpi_left_switch_is_in_right_position	KEYWORD2
cowpi_right_switch_is_in_right_position	KEYWORD2
cowpi_illuminate_right_led	KEYWORD2
cowpi_deluminate_right_led	KEYWORD2
cowpi_illuminate_left_led	KEYWORD2
cowpi_deluminate_left_led	KEYWORD2
cowpi_illuminate_internal_led	KEYWORD2
cowpi_deluminate_internal_led	KEYWORD2
cowpi_register_pin_ISR	KEYWORD2
cowpi_deregister_pin_ISR	KEYWORD2
cowpi_debounce_byte	KEYWORD2
cowpi_debounce_short	KEYWORD2


# CODE STRUCTURES (kind of)


# CONSTANTS

COWPI_PB	LITERAL1
COWPI_PC	LITERAL1
COWPI_PD	LITERAL1
A0_A5	LITERAL1
A0_A7	LITERAL1
D0_D7	LITERAL1
D8_D13	LITERAL1
D14_D19	LITERAL1
D14_D21	LITERAL1

LEFT_BUTTON_DOWN	LITERAL1
RIGHT_BUTTON_DOWN	LITERAL1
LEFT_SWITCH_LEFT	LITERAL1
RIGHT_SWITCH_LEFT	LITERAL1
LEFT_SWITCH_RIGHT	LITERAL1
RIGHT_SWITCH_RIGHT	LITERAL1
KEYPAD	LITERAL1
INPUT_X	LITERAL1
INPUT_Y	LITERAL1